000000000000000000000000
E0B00000000000000000000H
000000000000000000000000
h00000000000000000000b0e
000000000000000000000000